R	1231241	124125
NO      ./pics/wall_1.xpm
SO        ./pics/wood.xpm
EA        ./pics/wall_3.xpm





F 0, 0, 0
WE ./pics/eagle.xpm
C 0, 250, 250
S   ./pics/sprite_1.xpm



        11111111111111111111111 11
        100000000000000000100001
        101100222111000000200001
        100100000000000022220011111
111111111011000001110000000000001
1000000000110000011101111000100001
111101111111110111000100100001    
11110111111111011101010010001
11000000110101011100000010001
1222200002220S01110000010001
10000020020200001101010010001
112022011101010111111111110111
11110111 1110101 101111110001
11111111 1111111 111111111111
