R 		1400 	1401
NO /Users/huchoi/huchoi-git-6/cub3d/pics/wall_1.xpm
SO /Users/huchoi/huchoi-git-6/cub3d/pics/wall_2.xpm
WE /Users/huchoi/huchoi-git-6/cub3d/pics/wall_3.xpm
EA /Users/huchoi/huchoi-git-6/cub3d/pics/wall_4.xpm
S /Users/huchoi/huchoi-git-6/cub3d/pics/sprite_3.xpm
F 220, 100,0
C 225, 30,3

        1111111111111111111111111
        1000000000110000000W00001
        1011002221110000002000001
        100100000000000000000001
111111111011000001110000000000001
100000000011000001110111100011111
11110111111111011100010010001
11110111111111011101010010001
11000000110101011100000010001
1222200002220001100000010001
10000020020200001101010010001
112022011101010111111111110111
11110111 1110101 101111110001
11111111 1111111 111111111111
